555555555555555
555555555555555
555556555525555
555555555555555
555525555557555
555555555555555
555575555525555
555555555555555
555555555555555
555855555558555
555555555555555
555255555552555
555555555555555
