555555555555555
534343434343435
512121212121215
555555555555555
534343434343435
512121212121215
555555555555555
534343434343435
512121212121215
555555555555555
534343434343435
512121212121215
555555555555555


