555555555555555
535555553355535
514555531155515
552555515455555
544555555255535
522555555555515
555555555555555
535555434355555
515555212155555
555555555555555
535555555555435
515555555555215
555555555555555

