555555555555555
533343353343355
511121151121155
555545555554555
555525555552555
555545555545555
555525555525555
555535555555555
555415555554555
555255555552555
533433555334335
511211555112115
555555555555555

